SOOOOOOOOOOOOOO
OXXOXOXXXOXXOXO
OOOOXOOXOOOXXXO
OXOXXXOOOXOXOOO
OXOOOXXOXXOXOXO
OOOXOOOOXOOOOOO
OXOOOXXOOOXXXOX
OXOXOOXOXOOOOOO
OOOXXOXOXXXXOXO
XOXXOOXOOOOOOXO
OOOXXOXXOXXXOXO
OXOOOOOOOOOXOXO
OOOXXXOXOXOOOOO
XOXXOOOXXXXXXXO
OOOOOXOOOOOOOOE
